11, 11, 15, 50, 51, 51, 55, 51, 51, 55, 51, 51, 55, 55, 55, 51, 55, 55, 55, 55, 55, 51, 55, 51, 51, 55, 55, 55, 51, 55, 51, 55, 55, 55, 51,
15, 15, 11, 60, 01, 01, 02, 51, 55, 55, 51, 55, 55, 55, 55, 55, 51, 51, 51, 55, 55, 51, 55, 55, 51, 55, 51, 55, 55, 51, 51, 51, 55, 55, 56,
11, 11, 11, 11, 11, 15, 60, 01, 01, 01, 01, 01, 01, 01, 02, 51, 51, 55, 51, 51, 51, 55, 55, 51, 55, 51, 51, 55, 55, 51, 51, 51, 51, 51, 51,
11, 11, 15, 15, 11, 11, 11, 11, 11, 11, 11, 11, 11, 15, 60, 01, 01, 01, 01, 01, 01, 01, 01, 01, 01, 01, 01, 01, 01, 02, 51, 51, 55, 51, 56,
11, 11, 11, 11, 11, 11, 11, 11, 11, 11, 11, 11, 11, 11, 11, 11, 11, 11, 11, 11, 15, 15, 15, 11, 11, 15, 11, 11, 11, 60, 01, 02, 55, 55, 51,
11, 11, 11, 11, 11, 11, 11, 11, 11, 11, 11, 11, 11, 11, 11, 11, 11, 11, 11, 11, 11, 11, 11, 11, 11, 11, 11, 11, 11, 15, 15, 12, 55, 51, 56,
15, 11, 11, 11, 11, 11, 11, 11, 15, 11, 11, 15, 11, 40, 41, 42, 15, 11, 11, 15, 15, 11, 11, 11, 11, 11, 11, 11, 11, 11, 15, 60, 01, 02, 51,
15, 15, 11, 11, 40, 21, 21, 21, 42, 15, 11, 15, 15, 50, 55, 20, 41, 41, 41, 41, 41, 41, 41, 41, 41, 42, 15, 11, 11, 11, 11, 15, 15, 12, 56,
41, 41, 41, 41, 22, 51, 55, 51, 20, 21, 21, 21, 21, 22, 51, 55, 51, 55, 51, 51, 55, 51, 51, 51, 51, 20, 42, 11, 11, 11, 11, 15, 15, 12, 51,
51, 51, 51, 55, 55, 55, 55, 51, 55, 51, 55, 55, 51, 51, 51, 51, 55, 55, 55, 55, 51, 55, 51, 55, 55, 55, 20, 42, 11, 11, 11, 11, 15, 12, 51,
51, 51, 55, 51, 51, 51, 51, 55, 55, 51, 51, 51, 55, 55, 55, 55, 55, 55, 55, 51, 51, 51, 55, 55, 51, 55, 55, 52, 11, 11, 11, 11, 11, 12, 51,
51, 55, 55, 51, 51, 51, 51, 55, 55, 51, 51, 51, 55, 51, 51, 55, 51, 55, 55, 51, 55, 51, 51, 55, 51, 55, 51, 52, 11, 11, 11, 11, 11, 12, 51,
55, 55, 55, 51, 51, 55, 51, 51, 55, 55, 55, 51, 55, 51, 51, 51, 51, 55, 51, 55, 51, 55, 55, 55, 55, 51, 00, 62, 15, 11, 11, 11, 11, 12, 56,
55, 51, 51, 51, 55, 55, 51, 51, 51, 55, 55, 51, 55, 55, 55, 51, 55, 55, 55, 55, 55, 55, 51, 55, 55, 00, 62, 11, 11, 11, 11, 11, 15, 12, 51,
51, 51, 55, 55, 51, 51, 51, 55, 51, 55, 55, 55, 55, 51, 55, 55, 51, 00, 01, 01, 01, 01, 01, 01, 01, 62, 15, 15, 11, 11, 11, 15, 11, 12, 56,
51, 51, 55, 55, 51, 00, 01, 01, 01, 01, 01, 01, 01, 01, 01, 01, 01, 62, 15, 15, 11, 11, 11, 11, 15, 15, 11, 15, 11, 11, 11, 15, 40, 22, 56,
55, 51, 55, 00, 01, 62, 15, 11, 15, 11, 11, 11, 11, 11, 11, 11, 11, 11, 15, 11, 15, 15, 11, 11, 15, 15, 11, 15, 11, 11, 11, 40, 22, 55, 56,
55, 51, 55, 52, 15, 15, 11, 11, 11, 11, 11, 11, 11, 11, 11, 11, 11, 11, 11, 11, 11, 11, 11, 11, 11, 11, 11, 11, 11, 11, 40, 22, 51, 51, 51,
55, 51, 00, 62, 11, 11, 11, 11, 11, 11, 11, 11, 11, 11, 11, 11, 11, 11, 11, 15, 11, 11, 11, 11, 11, 11, 11, 11, 15, 40, 22, 51, 51, 51, 56,
00, 01, 62, 11, 11, 11, 11, 15, 11, 15, 11, 11, 11, 11, 11, 11, 11, 11, 11, 11, 11, 11, 15, 15, 15, 40, 41, 41, 41, 22, 51, 55, 55, 51, 51,
52, 15, 11, 11, 11, 11, 11, 40, 41, 41, 41, 41, 41, 41, 41, 41, 41, 41, 41, 41, 41, 41, 41, 41, 41, 22, 55, 55, 55, 51, 55, 51, 51, 55, 56,
52, 15, 11, 11, 11, 11, 15, 50, 51, 51, 51, 51, 51, 51, 55, 51, 51, 51, 51, 51, 55, 51, 55, 51, 55, 55, 55, 55, 55, 55, 55, 51, 55, 51, 56,
20, 42, 11, 11, 11, 11, 15, 60, 02, 55, 55, 55, 55, 55, 55, 55, 55, 51, 51, 55, 51, 51, 51, 51, 51, 51, 51, 55, 51, 55, 51, 51, 55, 55, 51,
51, 10, 11, 11, 15, 11, 15, 15, 60, 01, 01, 01, 01, 01, 01, 01, 01, 01, 01, 01, 01, 01, 01, 01, 01, 02, 51, 51, 51, 51, 51, 55, 51, 51, 56,
51, 10, 15, 11, 11, 11, 11, 11, 11, 15, 11, 15, 11, 15, 11, 11, 11, 11, 11, 15, 11, 15, 15, 11, 11, 60, 61, 61, 61, 61, 02, 55, 55, 55, 56,
51, 10, 11, 11, 11, 11, 15, 11, 11, 11, 15, 11, 11, 11, 11, 11, 11, 11, 11, 11, 11, 11, 11, 15, 15, 11, 15, 11, 11, 15, 60, 61, 02, 55, 56,
55, 20, 21, 21, 21, 21, 42, 11, 11, 11, 11, 11, 11, 15, 11, 11, 11, 11, 11, 11, 11, 11, 11, 11, 11, 11, 11, 15, 11, 11, 11, 11, 50, 51, 56,
55, 51, 51, 51, 51, 55, 20, 21, 21, 42, 11, 15, 11, 15, 11, 11, 40, 41, 41, 41, 41, 41, 42, 15, 15, 11, 11, 11, 11, 11, 11, 11, 50, 51, 56,
51, 51, 51, 55, 55, 51, 55, 55, 55, 20, 21, 21, 21, 21, 21, 21, 22, 55, 51, 55, 55, 51, 20, 21, 21, 42, 11, 11, 11, 11, 11, 11, 50, 55, 56,
51, 51, 51, 51, 55, 51, 55, 55, 55, 51, 55, 51, 51, 55, 51, 51, 51, 55, 55, 55, 55, 55, 55, 51, 51, 10, 11, 11, 11, 11, 11, 11, 50, 55, 51,
51, 55, 51, 55, 55, 51, 51, 51, 51, 55, 55, 51, 55, 51, 55, 55, 51, 55, 55, 51, 55, 55, 55, 51, 55, 20, 42, 11, 11, 11, 11, 11, 50, 51, 56,
55, 55, 55, 51, 55, 55, 51, 51, 55, 51, 51, 51, 51, 51, 55, 51, 55, 51, 51, 55, 51, 55, 55, 51, 55, 51, 52, 11, 11, 11, 11, 40, 22, 51, 51,
00, 01, 01, 01, 01, 01, 02, 55, 55, 51, 51, 55, 55, 51, 51, 55, 51, 55, 51, 51, 51, 55, 51, 55, 55, 51, 52, 11, 11, 15, 11, 50, 55, 55, 51,
62, 11, 11, 15, 15, 15, 60, 61, 61, 02, 51, 51, 55, 55, 55, 51, 51, 51, 55, 51, 51, 55, 51, 51, 00, 01, 62, 11, 11, 15, 11, 50, 51, 55, 56,
11, 11, 11, 15, 11, 15, 15, 11, 15, 60, 01, 01, 01, 01, 01, 01, 02, 55, 55, 51, 55, 00, 01, 01, 62, 11, 11, 11, 11, 11, 40, 22, 51, 51, 51,
11, 11, 11, 11, 11, 11, 11, 11, 11, 11, 11, 11, 11, 11, 15, 15, 60, 61, 61, 61, 61, 62, 15, 11, 11, 11, 11, 11, 15, 40, 22, 51, 55, 55, 56,
11, 11, 11, 11, 11, 11, 11, 11, 11, 11, 11, 15, 11, 15, 11, 11, 11, 11, 11, 11, 11, 11, 11, 11, 11, 11, 11, 40, 41, 22, 51, 55, 51, 55, 51,
11, 11, 11, 11, 11, 11, 11, 11, 11, 40, 41, 41, 41, 41, 41, 41, 41, 41, 41, 41, 41, 41, 41, 41, 41, 41, 41, 22, 51, 51, 51, 55, 51, 51, 56,
11, 11, 11, 11, 11, 15, 11, 40, 41, 22, 51, 55, 51, 51, 51, 51, 55, 51, 55, 55, 55, 51, 51, 55, 55, 55, 55, 55, 51, 55, 55, 51, 55, 51, 56,
15, 15, 11, 11, 15, 15, 11, 50, 55, 51, 51, 55, 51, 51, 51, 51, 51, 51, 51, 55, 51, 51, 55, 55, 51, 51, 51, 55, 55, 51, 51, 55, 51, 51, 56