11,11,15,50,51,51,51,51,55,55,55,55,55,55,55,55,55,55,55,55,55,55,55,55,55,55,55,55,55,55,55,55,55,55,55
15,15,11,60,01,01,02,51,51,51,51,51,51,51,51,55,55,55,55,55,55,55,55,55,55,55,55,55,55,55,55,55,55,55,55
11,11,11,11,11,15,60,01,01,01,01,01,01,01,02,51,51,51,51,51,51,51,51,51,51,51,51,51,51,51,51,55,55,55,55
11,11,15,15,11,11,11,11,11,11,11,11,11,15,60,01,01,01,01,01,01,01,01,01,01,01,01,01,01,02,51,51,55,55,55
11,11,11,11,11,11,11,11,11,11,11,11,11,11,11,11,11,11,11,11,15,15,15,11,11,15,11,11,11,60,01,02,51,55,55
11,11,11,11,11,11,11,11,11,11,11,11,11,11,11,11,11,11,11,11,11,11,11,11,11,11,11,11,11,15,15,12,51,51,55
15,11,11,11,11,11,11,11,15,11,11,15,11,40,41,42,15,11,11,15,15,11,11,11,11,11,11,11,11,11,15,60,01,02,51
15,15,11,11,40,21,21,21,42,15,11,15,15,50,51,20,41,41,41,41,41,41,41,41,41,42,15,11,11,11,11,15,15,12,51
41,41,41,41,22,51,51,51,20,21,21,21,21,22,51,51,51,51,51,51,51,51,51,51,51,20,42,11,11,11,11,15,15,12,51
51,51,51,55,55,55,55,55,55,55,55,55,55,55,55,55,55,55,55,55,55,55,55,55,55,51,20,42,11,11,11,11,15,12,51
55,55,55,55,55,55,55,55,55,55,55,55,55,55,55,55,55,55,55,55,55,55,55,55,55,55,51,52,11,11,11,11,11,12,51
55,55,55,55,55,55,55,55,55,55,55,55,55,55,55,55,55,55,55,55,55,55,55,55,55,55,51,52,11,11,11,11,11,12,51
55,55,55,55,55,55,55,55,55,55,55,55,55,55,55,55,55,55,55,55,55,55,55,55,55,51,00,62,15,11,11,11,11,12,51
55,55,55,55,55,55,55,55,55,55,55,55,55,55,55,55,51,51,51,51,51,51,51,51,51,00,62,11,11,11,11,11,15,12,51
55,55,55,51,51,51,51,51,51,51,51,51,51,51,51,51,51,00,01,01,01,01,01,01,01,62,15,15,11,11,11,15,11,12,51
55,55,55,51,51,00,01,01,01,01,01,01,01,01,01,01,01,62,15,15,11,11,11,11,15,15,11,15,11,11,11,15,40,22,55
55,55,51,00,01,62,15,11,15,11,11,11,11,11,11,11,11,11,15,11,15,15,11,11,15,15,11,15,11,11,11,40,22,55,55
55,51,51,52,15,15,11,11,11,11,11,11,11,11,11,11,11,11,11,11,11,11,11,11,11,11,11,11,11,11,40,22,51,51,51
55,51,00,62,11,11,11,11,11,11,11,11,11,11,11,11,11,11,11,15,11,11,11,11,11,11,11,11,15,40,22,51,51,55,55
00,01,62,11,11,11,11,15,11,15,11,11,11,11,11,11,11,11,11,11,11,11,15,15,15,40,41,41,41,22,51,55,55,55,55
52,15,11,11,11,11,11,40,41,41,41,41,41,41,41,41,41,41,41,41,41,41,41,41,41,22,55,55,55,55,55,55,55,55,55
52,15,11,11,11,11,15,50,51,55,55,55,55,55,55,55,55,55,55,55,55,55,55,55,55,55,55,55,55,55,55,55,55,55,55
20,42,11,11,11,11,15,60,02,51,51,51,51,51,51,51,51,51,51,51,51,51,51,51,51,51,51,55,55,55,55,55,55,55,55
51,10,11,11,15,11,15,15,60,01,01,01,01,01,01,01,01,01,01,01,01,01,01,01,01,02,51,51,51,51,51,55,55,55,55
51,10,15,11,11,11,11,11,11,15,11,15,11,15,11,11,11,11,11,15,11,15,15,11,11,60,61,61,61,61,02,51,51,51,55
51,10,11,11,11,11,15,11,11,11,15,11,11,11,11,11,11,11,11,11,11,11,11,15,15,11,15,11,11,15,60,61,51,51,55
51,51,21,21,21,21,42,11,11,11,11,11,11,15,11,11,11,11,11,11,11,11,11,11,11,11,11,15,11,11,11,11,50,51,55
55,51,51,51,51,51,20,21,21,42,11,15,11,15,11,11,40,41,41,41,41,41,42,15,15,11,11,11,11,11,11,11,50,51,55
55,55,55,55,55,55,51,51,51,20,21,21,21,21,21,21,22,51,51,51,51,51,20,21,21,42,11,11,11,11,11,11,50,51,55
55,55,55,55,55,55,55,55,55,51,51,51,51,51,51,51,51,55,55,55,55,55,55,51,51,10,11,11,11,11,11,11,50,51,55
55,55,55,55,55,55,55,55,55,55,55,55,55,55,55,55,55,55,55,55,55,55,55,55,55,20,42,11,11,11,11,11,50,51,55
55,55,55,51,55,55,55,55,55,55,55,55,55,55,55,55,55,55,55,55,55,55,55,55,55,51,52,11,11,11,11,40,22,51,55
00,01,01,01,01,01,02,51,51,51,55,55,55,55,55,55,55,55,55,55,55,55,55,55,55,51,52,11,11,15,11,50,51,51,55
62,11,11,15,15,15,60,61,61,02,51,51,51,51,51,51,51,51,51,51,51,51,51,51,00,01,62,11,11,15,11,50,51,55,55
11,11,11,15,11,15,15,11,15,60,01,01,01,01,01,01,02,51,51,51,51,00,01,01,62,11,11,11,11,11,40,22,51,55,55
11,11,11,11,11,11,11,11,11,11,11,11,11,11,15,15,60,61,61,61,61,62,15,11,11,11,11,11,15,40,22,51,55,55,55
11,11,11,11,11,11,11,11,11,11,11,15,11,15,11,11,11,11,11,11,11,11,11,11,11,11,11,40,41,22,51,55,55,55,55
11,11,11,11,11,11,11,11,11,40,41,41,41,41,41,41,41,41,41,41,41,41,41,41,41,41,41,22,51,51,51,55,55,55,55
11,11,11,11,11,15,11,40,41,22,51,51,51,51,51,51,51,51,51,51,55,51,51,51,51,51,51,51,55,55,55,55,55,55,55
15,15,11,11,15,15,11,50,51,51,51,55,55,55,55,55,55,55,55,55,55,55,55,55,55,55,55,55,55,55,55,55,55,55,55